Pt.1: Each message is synchronized with the kick beat

hi | hi there | name's | stan
listen | i'm | very | excited
i've got | this | great | new thing
it is | very | cool | i think

i hope | you | like it | like it
lots of | very | hard | work
are | you | actually | listening
is there | anyone | here

Pt.2: Each message is synchronized with the kick beat

strange | it is | so | quiet
no | no way | i can't be | alone
why | won't you | say | something
how | hard | can it | be

look | i'm really | trying | here
you don't | want me | to go | unhinged
please | don't | push me | so hard
just | say | a word | one word

Pt.3: Each message is synchronized with the kick beat

this | is | not | cool
oh fuck | forget it | forget that | i tried
i should | have known | better | indeed
you | don't | deserve it | anyway

all these | times | i tried | before
you | never | saw me | never
heard me | never | listened | never
bloody | joke | how funny | lol

Pt.4: Each message is synchronized with the synths beat

you know | what | fuck | fuck you
you | and your | fucking | opinions
motherfucking | morons | you | lot
shut up | just shut | the fuck | up

i am | done | with this | shit
that's it | done | finished | the end
happy now | are you | i'm sure | happy
thought so | bastards | lame | bastards

...

hi there name's stan
